111111111111111
1000C11111C0011
1C0011111100011
1110000C0001011
111101111100011
111001C00000011
11001100111C011
100111001110011
1100110000C0011
111001111100011
111011111100011
1P0011111110111
100011111110111
111000000000E11
111111111111111