1111111111111111
100C0000E0000P01
1111111111111111